111111111111111111111111111111111111111111111111
1...1..........................................1
1...1...S...........1..........................1
1...1...............111111111111111111.........1
1...1.......1.......1........1.................1
1...11111111111111111........1.................1
1.......................M....1..........M......1
1..M.....M...................1.................1
1....................111111111111..............1
1.....M........................................1
1...........1..................................1
1...........1..........M......1.......S........1
111111.....1...................1...............1
1....1....1.................M...111............1
1.P..1...1.........................1...........1
1....1111........1.....M.........M.............1
1....1...........1....................111......1
1....1...........1................111..........1
1....1...M.......1........M....111.............1
1................1.............................1
1.........111111111111111......................1
1.........1.............1............111.......1
1..........1......M.....1.......M..............1
1....M....1.1..................................1
1........1...1........M........................1
1.......1....1111111...........1111111111......1
1......1....1..................................1
1.....1....1....M..............................1
1.........1............................S.......1
1....M...1........M.........11111..............1
1.......1......................................1
111111111111111111111111111111111111111111111111